{
  "ก": "k",
  "ข": "k",
  "ฃ": "k",
  "ค": "k",
  "ฅ": "k",
  "ฆ": "k",
  "จ": "t",
  "ฉ": "t",
  "ช": "t",
  "ซ": "t",
  "ฌ": "t",
  "ฎ": "t",
  "ฏ": "t",
  "ฐ": "t",
  "ฑ": "t",
  "ฒ": "t",
  "ด": "t",
  "ต": "t",
  "ถ": "t",
  "ท": "t",
  "ธ": "t",
  "ศ": "t",
  "ษ": "t",
  "ส": "t",
  "บ": "p",
  "ป": "p",
  "ผ": "p",
  "ฝ": "p",
  "พ": "p",
  "ฟ": "p",
  "ภ": "p",
  "ง": "ng",
  "ญ": "n",
  "ณ": "n",
  "น": "n",
  "ร": "n",
  "ล": "n",
  "ม": "m",
  "ย": "i",
  "ว": "u"
}
